11111111
10000001
10000001
11111111

11111111
10000002
10000001
11111111

11111111
10000001
10000001
11111111

11111111
10000001
100N0001
11111111

         11111111
         10000001
         10000001
         11111111

11111111
10000001
100N0001
11111001
    11011111
    1000000W1
    10000001
    11111111

11111111
10000001
100N0001
11111001
    11111 11
    10000001
    10000001
    11111111

11111111
10000001
100N0001
11111111
               1111 111
               10000001
               10000001
               11111111
