        1111111111111111111111111
        1000000000110000000000001
        1011000001110000002000001
        1001000000000000000000001
111111111011000001110000000000001
100000000011000001110111111111111
11110111111111011100000010001
11110111111111011101010010001
11000000110101011100000010001
10002000000000001100000010001
10000000000000001101010010001
11000001110101011111011110N0111
11110111 1110101 101111010001
11111111 1111111 111111111111

        1111111111111111111111111
        1000000000110000000000001
        1011000001110000002000001
        1001000000000000000000001
111111111011000001110000000000001
1000000000110000011101111111111111111111111111111111111111111
11110111111111011100000010001
11110111111111011101010010001
11000000110101011100000010001111111111
10002000000000001100000010001
10000000000000001101010010001111111111111111111111111111111
11000001110101011111011110N0111
11110111 1110101 101111010001
11111111 1111111 111111111111
1111111111111111111111111111111111111111111111111111111111111111111


        1111111111111111111111111
 1      1000000000110000000000001
101     1011000001110000002000001
 1      1001000000000000000000001
        1111111111111111111111111
111111111011000001110000000000001
100000000011000001110111111111111
11110111111111011100000010001
11110111111111011101010010001
11000000110101011100000010001
10002000000000001100000010001
10000000000000001101010010001
11000001110101011111011110N0111
11110111 1110101 101111010001
11111111 1111111 111111111111


11111111
10000001
100N0001
11111111

11111111
10000001111111111111111111111111111111111111111111111111111
100N0001111111111111111111111111111111111111
11111111

111111111111111111111111111111111111111111111111111111
10000001                                     111111111
100N0001
1111111111111111111111111111111111111111111111111

111111111111111111111111111111111111111111111111111111
10000001                                     111111111
100N0001                                     111111111
1111111111111111111111111111111111111111111111111


11111111         111
10000001         101
100N0001         111 
111111111111     

11111111
10000001
100N0001
11111111
        111111111111111
        100000000000001
        111111111111111

11111111
10000001
100N0001
11111111
    111111111111111
    100000000000001
    111111111111111

1111111111111111111111111111111111111111111111111111111111111111111111
10000001
100N0001
11111001
    10011111111111111111111111111111111111111111111111111111111111111111111111111111111111111111
    100000000000001
    111111111111111
